{
  "name": "stage1_marker",
  "grid_w": 30, "grid_h": 30, "cell_px": 64,
  "origin_x": 0.5, "origin_y": 0.5,
  "legend": "G=Grass R=Road I=Dirt W=Water D=Bridge S=Sand | H=house T=tree K=stone P=bridge(marker)",
  "base": [
    "TTTTTGTWTGGGGGGGGRGGGGGGGGGGGG",
    "TTTTTGGWTGGGGGGGGRGGGGGGGGGGGG",
    "TTTTTGWWGGGGGGGGGRGGGGGGGGGGGG",
    "TTTTTGWGGKTIIIIIGRRRRRRRRRRRGG",
    "TTTTGWWGGKGIIIIIGGGGGGGGGGKRGG",
    "TTTGGWWGGGGIIIIIIIIITGGGGGGRRR",
    "TTTTGWWGGGGGGGIIIIIIGKKGGGGRGG",
    "TTTGGGWGGGGGGGIIIIIIGGGGGGGRGG",
    "TTTGTGWGGKGGGGGGGGGGGGGGGGGRGG",
    "TTGGGGWWWGGGGGGGGGGHHHHGGGTRGG",
    "TTGTGGGGWWGGGGGGGGGHHHHGGGGRGG",
    "TTGGGGGGGWWWGGGGTGGHHHHGGGGRGG",
    "TTTGGGGGGGWWGGTGGKTHHHHGTGGRGG",
    "TTTGGGGGGGWWKKGGGGGGGRGGGGKRGG",
    "TTGGTGGGGPPPPRRRRRRRRRRRRRRRRR",
    "TTGTGGGGRPPPPRRRRRRRRRRRRRRRRR",
    "TTGGTGGRRGWWGGKGTGGGRTGGGGGRGG",
    "TTGGGGRRGGWWGGHHHHGGRGHHHHGRGG",
    "TTTGGGRGGGWWGGHHHHGGRGHHHHGRGG",
    "TTTGGRRGWWWGGGHHHHGGRGHHHHGRGG",
    "TTTTGRGGWGGGGGHHHHGGRGHHHHGRGG",
    "TTTTGRGGWWGGGGGGRRRRRGGRGGGRGG",
    "TTTGRRGGGWWGGGGGGGGGRRRRGGTRGG",
    "TTTGRGGGGGWGGGGGGGGGGGGGGGGRGG",
    "TTGRRGGGGGWGGGGGIIIIIIIIGGGRGG",
    "TTRRGGGTGGWWGGGGIIIIIIIIGGGRGG",
    "TGRGGTGGGGGWGGGGIIIIIIIIGGGRGG",
    "GRRTTTTGTGGWGGGGGGGGGGGGKTGRGG",
    "RRTTTTTTGTGWGGGGGGGGGTKKKKGRGG",
    "RTTTTTTTTGGWGGGGGGGGKGKGGGGRGG"
  ]
}
