{
  "name": "stage1_village",
  "grid_w": 30, "grid_h": 30, "cell_px": 64,
  "origin_x": 0.5, "origin_y": 0.5,
  "legend": "G=Grass R=Road I=Dirt W=Water D=Bridge S=Sand B=Building(house,blocked) .=Grass",
  "base": [
    "GGGGGGGWGGGGGGGGGRIIIIIIIIIRGG",
    "GGGGGGGWGGGGGGGGGRIIIIIIIIIRGG",
    "GGGGGGWWGGGGGGGGGRRRRRRRRRRRGG",
    "GGGGGGWGGGGGGGGGGGGGGGGGGGGRGG",
    "GGGGGWWGGGGGGGGGGGGGGGGGGGGRGG",
    "GGGGGWWGGGGGGGGGGGGGGGGGGGGRGG",
    "GGGGGWWGGGGGGGGGGGGGGGGGGGGRGG",
    "GGGGGGWGGGGGGGGGGGGGGGGGGGGRGG",
    "GGGGGGWGGGGGGGGGGBBBBBBGGGGRGG",
    "GGGGGGWWWGGGGGGGGBBBBBBGGGGRGG",
    "GGGGGGGGWWGGGGGGGBBBBBBGGGGRGG",
    "GGGGGGGGGWWWGGGGGBBBBBBGGGGRGG",
    "GGGGGGGGGGWWGGGGGBBBBBBGGGGRGG",
    "GGGGGGGGGGWWGGGGGBBBBBBGGGGRGG",
    "GGGGGGGGGRWWRRRRRRRRRRRRRRRRRR",
    "GGGGGGGGRRWWRRRRRRRRRRRRRRRRRR",
    "GGGGGGGRRGWWGGGGGGGGGGGGGGGRGG",
    "GGGGGGRRGGWWGGGGGGGGGGGGGGGRGG",
    "GGGGGGRGGGWWGGGGGGGGGGGGGGGRGG",
    "GGGGGRRGWWWGGGGGGGGGGGGGGGGRGG",
    "GGGGGRGGWGGGGGGGGGGGGGGGGGGRGG",
    "GGGGGRGGWWGGGGGGGGGGGGGGGGGRGG",
    "GGGGRRGGGWWGGGGGGGGGGGGGGGGRGG",
    "GGGGRGGGGGWGGGGGGGGGGGGGGGIRII",
    "GGGRRGGGGGWGGGGGGGGGGGGGGIIRII",
    "GGRRGGGGGGWWGGGGGGGGGGGGIIIRII",
    "GGRGGGGGGGGWGGGGGGGGGGGIIIIRII",
    "GRRGGGGGGGGWGGGGGGGGGGIIIIIRII",
    "RRGGGGGGGGGWGGGGGGGGGIIIIIIRII",
    "RGGGGGGGGGGWGGGGGGGGGIIIIIIRII"
  ]
}
