{
  "name": "stage1_village",
  "grid_w": 30, "grid_h": 30, "cell_px": 64,
  "origin_x": 0.5, "origin_y": 0.5,
  "legend": "G=Grass R=Road I=Dirt W=Water D=Bridge S=Sand .=Grass",
  "base": [
    "GGGGGGSWWSGGGGGGRRIIIIIIIIIRRG",
    "GGGGGGSWWSGGGGGGRRIIIIIIIIIRRG",
    "GGGGGSWWWSGGGGGGRRRRRRRRRRRRRG",
    "GGGGGSWWSGGGGGGGGGGGGGGGGGGRRG",
    "GGGGGSWWSGGGGGGGGGGGGGGGGGGRRG",
    "GGGGGSWWSGGGGGGGGGGGGGGGGGGRRG",
    "GGGGGSWWWSGGGGGGGGGGGGGGGGGRRG",
    "GGGGGSWWWSGGGGGGGGGGGGGGGGGRRG",
    "GGGGGGSWWSSGGGGGGGGGGGGGGGGRRG",
    "GGGGGGGSWWWSGGGGGGGGGGGGGGGRRG",
    "GGGGGGGGSWWWSSGGGGGGGGGGGGGRRG",
    "GGGGGGGGGSWWWWSGGGGGGGGGGGGRRG",
    "GGGGGGGGGGSWWWSGGGGGGGGGGGGRRG",
    "GGGGGGGGGGSWWWSGGGGGGGGGGGGRRG",
    "GGGGGGGGGRDDDDDRRRRRRRRRRRRRRR",
    "GGGGGGGGRRDDDDDRRRRRRRRRRRRRRR",
    "GGGGGGGRRRSWWWSGGGGGGGGGGGGRRG",
    "GGGGGGGRRGSWWWSGGGGGGGGGGGGRRG",
    "GGGGGGRRGGSWWWSGGGGGGGGGGGGRRG",
    "GGGGGGRRGGSWWSGGGGGGGGGGGGGRRG",
    "GGGGGGRRGGSWWSGGGGGGGGGGGGGRRG",
    "GGGGGGRRGGGSWWSGGGGGGGGGGGGRRG",
    "GGGGGGRRGGGGSWWSGGGGGGGGGGGRRG",
    "GGGGGRRGGGGGSWWSSGGGGGGGGGIRRI",
    "GGGGRRGGGGGGGSWWWSGGGGGGGIIRRI",
    "GGGRRGGGGGGGGGSWWSGGGGGGIIIRRI",
    "GGRRGGGGGGGGGGSWWSGGGGGIIIIRRI",
    "GRRGGGGGGGGGGGSWWSGGGGIIIIIRRI",
    "RRGGGGGGGGGGGGSWWSGGGIIIIIIRRI",
    "RGGGGGGGGGGGGGSWWSGGGIIIIIIRRI"
  ]
}
