{
  "name": "stage1_village",
  "grid_w": 30, "grid_h": 30, "cell_px": 64,
  "origin_x": 0.5, "origin_y": 0.5,
  "legend": "G=Grass R=Road I=Dirt W=Water D=Bridge S=Sand B=Building(house,blocked) .=Grass",
  "base": [
    "GGGGGGGWGGGGGGGGGRGGGGGGGGGGGG",
    "GGGGGGGWGGGGGGGGGRGGGGGGGGGGGG",
    "GGGGGGWWGGGGGGGGGRGGGGGGGGGGGG",
    "GGGGGGWGGGGGGGGGGRRRRRRRRRRRGG",
    "GGGGGWWGGGGIIIIIGGGGGGGGGGGRGG",
    "GGGGGWWGGGGIIIIIGGGGGGGGGGGRRR",
    "GGGGGWWGGGGIIIIIIIIIGGGGGGGRGG",
    "GGGGGGWGGGGGGGIIIIIIGGGRRRRRGG",
    "GGGGGGWGGGGGGGIIIIIIGGGGGGGRGG",
    "GGGGGGWWWGGGRGGGGGGGGGGGGGGRGG",
    "GGGGGGGGWWRRRGGGGGGGGGGGGGGRGG",
    "GGGGGGGGGWWWGGGGGGGGGGGGGGGRGG",
    "GGGGGGGGGGWWGGGGGGGGGGGGGGGRGG",
    "GGGGGGGGGGWWGGGGGGGRGGGRGGGRGG",
    "GGGGGGGGGRWWRRRRRRRRRRRRRRRRRR",
    "GGGGGGGGRRWWRRRRRRRRRRRRRRRRRR",
    "GGGGGGGRRGWWGGGGGGGGGRGGGGGRGG",
    "GGGGGGRRGGWWGGGGGGGGGRGGGGGRGG",
    "GGGGGGRGGGWWGGGGGGGGGRGGGGGRGG",
    "GGGGGRRGWWWGGGGGGGGGRRGGRGGRGG",
    "GGGGGRGGWGGGGGGGGGGGGRRRRGGRGG",
    "GGGGGRGGWWGGGGGGGGGGGGGGGGGRGG",
    "GGGGRRGGGWWGGGGGIIIIIIIIGGGRGG",
    "GGGGRGGGGGWGGGGGIIIIIIIIGGGRGG",
    "GGGRRGGGGGWGGGGGIIIIIIIIGGGRGG",
    "GGRRGGGGGGWWGGGGGGGGGGGGGGGRGG",
    "GGRGGGGGGGGWGGGGGGGGGGGGGGGRGG",
    "GRRGGGGGGGGWGGGGGGGGGGGGGGGRGG",
    "RRGGGGGGGGGWGGGGGGGGGGGGGGGRGG",
    "RGGGGGGGGGGWGGGGGGGGGGGGGGGRGG"
  ]
}
